1;1;1;1;1;1;1;1;1;1;1;1;1;1;1;1
1;5;4;5;1;3;5;10;3;2;3;1;1;3;1;1
1;1;5;1;3;5;4;5;2;3;15;1;3;5;4;5
1;1;5;1;1;7;4;5;7;2;7;5;4;17;5;4
1;1;1;5;1;3;5;4;7;2;3;5;4;7;10;1
1;5;4;5;1;1;5;4;1;3;1;5;3;2;3;10